during 	->PN
his speech 	->N
on the champ 	->SV
de mars 	-> PN
,	-> PCT
emmanuel macron asked the french to celebrate 	->PN
his victory 	->N
by applauding him every evening 	->PN
at 8 p.m. " 	->PN
for an indefinite period " 	-> PN
.	-> PCT
before adding 	-> N
â€œ	-> PCT
to applaud me is also 	->PV
to applaud retirement 	->PN
at 65 	-> PN
,	-> PCT
the breakage of 	->SN
the public service 	-> N
,	-> PCT
the conditioned rsa 	-> N
and	-> CONJ
a whole bunch of reforms 	->SN
that 	->N
i keep under 	->SV
my elbow 	-> N
!	-> PCT
there will be 	->N
a lot of surprises 	-> SN
!	-> PCT
" 	-> PN
.	-> PCT
a mouth - watering teaser from 	->SN
the president 	-> N
.	-> PCT
